@ Verbs
take/catch/capture: capio, capere, cepi, captus
make/do: facio, facere, feci, factus
run away/flee: fugio, fugere, fugi, fugitus
seek/beg/ask for/make for: peto, petere, petivi, petitus
leave/leave behind: relinquo, relinquere, reliqui, relictus
laugh/smile: rideo, ridere, risi, risus
look at/watch: specto, spectare, spectavi, spectatus

@ Nouns
love: amor, amoris, (m)
sky/heaven: caelum, caeli, (n)
head: caput, capitis, (n)
shout/shouting/noise: clamor, clamoris, (m)
leader: dux, ducis, (m)
I: ego
brother: frater, fratris, (m)
journey: iter, itineris, (n)
young man: iuvenis, iuvenis, (m)
sea: mare, maris, (n)
husband: maritus, mariti, (m)
mother: mater, matris, (f)
soldier: miles, militis, (m)
ship: navis, navis, (f)
name: nomen, nominis, (n)
night: nox, noctis, (f)
father: pater, patris, (m)
queen: regina, reginae, (f)
kingdom: regnum, regni, (n)
king: rex, regis, (m)
old man: senex, senis, (m)
you: tu
crowd: turba, turbae, (f)
city/town: urbs, urbis, (f)

@ Adjectives
long: longus, longa, longum, (212)
middle/middle of: medius, media, medium, (212)
my: meus, mea, meum, (212)
first: primus, prima, primum, (212)
your/yours: tuus, tua, tuum, (212)

@ Regulars
why: cur
is it: -ne
surely: nonne
surely not: num
after/behind: post
when: quando
where to: quo
where: ubi
where from: unde