@ Verbs
hear/listen: audio, audire, audivi, auditus
drink: bibo, bibere, bibi, bibitus
guard: custodio, custodire, custodivi, custoditus
give: do, dare, dedi, datus
sleep: dormio, dormire, dormivi, dormitus
lead/take: duco, ducere, duxi, ductus
have/hold: habeo, habere, habui, habitus
say: inquam
find: invenio, invenire, inveni, inventus
order: iubeo, iubere, iussi, iussus
read/choose: lego, legere, legi, lectus
send: mitto, mittere, misi, missus
warn/advise: moneo, monere, monui, monitus
punish: punio, punire, punivi, punitus
write: scribo, scribere, scripsi, scriptus
sit: sedeo, sedere, sedi, sessus
frighten: terreo, terrere, terrui, territus
fear: timeo, timere, timui
drag: traho, trahere, traxi, tractus
come: venio, venire, veni, ventus
see: video, videre, vidi, visus

@ Nouns
field: ager, agri, (m)
year: annus, anni, (m)
water: aqua, aquae, (f)
weapons: arma, armorum, (n)
help: auxilium, auxilii, (n)
war: bellum, belli, (n)
gift/present: donum, doni, (n)
hold: hora, horae, (f)
book: liber, libri, (m)
wall: murus, muri, (m)
danger: periculum, periculi, (n)
boy: puer, pueri, (m)
shop/inn: taberna, tabernae, (f)
temple: templum, templi, (n)
word: verbum, verbi, (n)
wine: vinum, vini, (n)
man/male: vir, viri, (m)

@ Regulars
from/away from/by/by means of/with: a/ab
with: cum
about/from/down from: de
ten: decem
from/out of/out: e/ex
in/into/on/onto: in
five: quinque